S002002000
0012001200
0000320220
0000020003
0000120202
0000100100
0202000320
3200000000
0200000010
0001000002