S112001320
0010003110
0030001011
2022001000
0022001202
0100021010
1101202200
0001201000
0202023020
2010000300