S210000200
0022000000
0200000000
0230000000
0202103201
2000001000
0000000101
0000100020
0010000000
2000122000