S000002110
1200000000
2020000020
1000000001
0000100020
0220110300
1000010021
0100100011
0011300012
0000200020