S100000000
0001021000
2000021000
0010000000
0210020000
0010000100
0000100122
2000212200
0002020100
0200200203