S200001020
0022000000
0102010212
2222010102
0001020110
0202201200
0000013000
0000200000
1120202000
0001010100