S002100110
0000010002
0010001001
0200000100
2001111020
0020201201
0232022010
0122020000
0210010002
0000000102