S101000130
1122020120
0000000000
1020010013
0000000200
2022201121
2001010020
0210000122
0002000100
0210022000