S021000000
0011002020
0000220130
2012002100
0000022300
0002002100
1001221200
2012011200
0013130122
1000010000