S000002100
0021000000
2000000000
0000102000
3102000003
0000000001
0020200202
0000200220
0012000000
0203001203