S000000000
1020002002
0000100000
0000010202
2000021000
0100020012
0000002000
2202011001
0100001003
2000020021