S001000201
0000021012
0211000020
2010000000
0000000202
0002000300
0010000000
2000002200
1000000000
0000002002