S200010001
2102000300
0210002021
0000100000
0100000010
3000022000
2130120101
0102012101
0010000310
0200000000