S100001100
0000002002
2020000020
0000000103
0000020120
2000002000
0030022010
0000000100
0001020000
0002100110