S010012022
0200010110
2002210000
0010002120
0310100000
0320000000
0002010002
0100200002
0200001022
0000020300